29,47,64,64,1800,1500
XXXXXXXXXXXXXXXXXXXXXXXXXXXXX
XXXXXXXXXXXXXXXXXXXXXXXXXXXXX
XXXXXXXXXXXXXXXXXXXXXXXXXXXXX
XXXXXXXXXXXXXXXXXOXXXXXXXXXXX
XXXXXXXXXXXXXXXOOOOOXXXXXXXXX
XXXXXXXXXXXXXOOOOOOOXXXXXXXXX
XXXXXXXXXXXXXOOOOOOOXXXXXXXXX
XXXXXXXXXXXOOOOOOOOOXXXXXXXXX
XXXXXXXXXXXOOOOOOoOOOXXXXXXXX
XXXOXXXXXXOOOOOOooOOOXXXXXXXX
XXXOOXXXXXOOOOooooOOOOOOXXXXX
XXOOOXXXXOOOOoooooOOOOOOOXXXX
XXOOOOOXXOOOOXoooooOOOOOOOXXX
XXOOOOOXOOOOXXoooooOOOOOOXXXX
XXXOOOOOOOOOXXXXXXooOOOOOXXXX
XXXOOOOOOOXXXXXXXXoOOOOOXXXXX
XXXXOOOOOOXXXXXXXXXoOOOOXXXXX
XXXXOOOOOXXXXXXXXXXOOOOXXXXXX
XXXXXOOOOXXXXXXXXXXOOOOOXXXXX
XXXXXOOOXXXXXXXXXXOOOOOOXXXXX
XXXXXoOOOXXXXXXXXXOOOOOOXXXXX
XXXXooooOXXXXXXXXXOOooOXXXXXX
XXXXXooooOOOOOOXXXXXoooOXXXXX
XXXXXooooOOOOOOXXXXXooOOXXXXX
XXXXXXooooOOOOOOXXXXXooOOOXXX
XXXXXXooooOOOOOXXXXXXoOOOOXXX
XXXXXXXooooOXOOXXXXXXXOOOOOXX
XXXXXXXooooXXOXXXXXXXXOOOOOXX
XXXXXXXXooooXXXXXXXXXXXOOOOOX
XXXXXXXXoooOXXXXXXXXXXXOOOOOX
XXXXXXXXXoOOOXXOXXXXXXXXOOOOX
XXXXXXXXXOOOOOOOXXXXXXXXOOOOX
XXXXXXXXXXOOOOOOOXXXXXXXXOOOX
XXXooOOOOOOOOOOOOXXXXXXXXOOOX
XXXoooOOOOOOOOOOOXXXXXXXXXOOX
XXooooOOOOOOOOOOOXXXXXXXOOOXX
XXXoooOOOOOOOOOOOOXXXXXOOOOXX
XXooooOOOOOoOOOOOOXOOOOOOOXXX
XXooooOOOOOooOOOOOOOOOOOOOXXX
XXoooooOOOoooOOOOOOOOOOOOOXXX
XXoooooooOoooooooOOOOOOOOOOXX
XXoooooooooooooooOOOOOOOOOOXX
XXoooooooooooooooOOOOOOOOOOOX
XXoooooooooooooooOOOOOOOOOOOX
XXXooooooooooooooOOOOOOOOOOOX
XXXXXXXXXXXXXXXXXXXXXXXXXXXXX
XXXXXXXXXXXXXXXXXXXXXXXXXXXXX
