38,50,64,64,2400,1600
XXXXXXXXXXXXXXXXXXXXXXXXXXXXXXXXXXXXXX
XXXXXXXXXXXXXXXXXXXXXXXXXXXXXXXXXXXXXX
XXXXXXXXXXXXXXXXXXXXXXXXXXXXXXXXXXXXXX
XXXXXXXXXXXXXXXXXXXXXXXXXXXXXXXXXXXXXX
XXXXXXXXXXXXXXXXXXXXXXXXXXXXXXXXXXXXXX
XXXXXXXXXXXXXXXXXXXXXXXXXXXXXXXXXXXXXX
XXXXXXXXXXXXXXXXXXXXXXOOOOOOXXXXXXXXXX
XXXXXXXXXXXXXXXXXXXXXOOOOOOOOXXXXXXXXX
XXXXXXXXXXXXXXXXXXXXXOOOOOOOOOXXXXXXXX
XXXXXXXXXXXXXXXXXXXXXOOOOOOOOOXXXXXXXX
XXXXXXXXXXXXXXXXXXXXXXOOOOOOOOOXXXXXXX
XXXXXXXXXXXXXXXXXXXXXOOOOOOOOOXXXXXXXX
XXXXXXXXXXXXXXXXXXXXXXOOOOOOOOOXXXXXXX
XXXXXXXXXXXXXXXXXXXXXXOOOOOOOOXXXXXXXX
XXXXXXXXXXXXXXXXXXXXXXXOOOOOOOOXXXXXXX
XXXXXXXXXXXXXXXXXXXXXXXOOOOOOOXXXXXXXX
XXXXXXXXXXXXXXXXXXXXXXXXXOOOOOOXXXXXXX
XXXXXXXXXXXXXXXXXXXXXXXXXOOOOOXXXXXXXX
XXXXXXXXXXXXXXXXXXXXXXXXXXOOOOOXXXXXXX
XXXXXXXXXXXXXXXXXXXXXXXXXXOOOOXXXXXXXX
XXXXOOOOOOOOOOXXXXXXXXXXXXXOOOOXXXXXXX
XXXOOOOOOOOOOOXXXXXXXXXXXXOOOOOXXXXXXX
XXXOOOOOOOOOOOOXXXXXXXXXXXXOOOOXXXXXXX
XXOOOOOOOOOOOOOXXXXXXXXXXXOOOOXXXXXXXX
XXOOOOOOOOOOOoooXXXXXXXXXXXOOOXXXXXXXX
XOOOOOOOOOOOOoooXXXXXXXXXXOOOXXXXXXXXX
XOOOOOOOOOOOOOoooXXXXXXOXXXOOXXXXXXXXX
XOOOOOOOOOOOOooooXXXXXOOXXOOOXXXXXXXXX
XOOOOOOOOOOOOoooooXXXXOOOOOOOOXXXXXXXX
XOOOOOOOOOOOooooooXXXOOOOOOOOOOXXXXXXX
XXOOOOOOOOOOooooooOOXOOOOOOOOOOOXXXXXX
XXOOOOOOOOOooooooOOOOOOOOOOOOOOOXXXXXX
XXXOOOoOOOOooooooOOOOOOOOOOOOOOOOXXXXX
XXXOoooOoOooooooOOOOOOOOOOOooOOOXXXXXX
XXXXooooooooooooOOOOOOooooOoooOXXXXXXX
XXXXooooooooooooOOoooooooooooXXXXXXXXX
XXXXXooooooooooooooooooooooooXXXXXXXXX
XXXXXooooooooooooooooooooooXXXXXXXXXXX
XXXXXXXooooooooooooooooooooOXXXXXXXXXX
XXXXXXXXooooooooooooooooooOOXXXXXXXXXX
XXXXXXXXXXXXXXXXXXXXXXXXXXXOOXXXXXXXXX
XXXXXXXXXXXXXXXXXXXXXXXXXXXOOXXXXOOXXX
XXXXXXXXXXXXXXXXXXXXXXXXXXXXOOXXOOOOXX
XXXXXXXXXXXXXXXXXXXXXXXXXXXXOOooOOOOXX
XXXXXXXXXXXXXXXXXXXXXXXXXXXXXOoooOOOOX
XXXXXXXXXXXXXXXXXXXXXXXXXXXXXooooOOOOX
XXXXXXXXXXXXXXXXXXXXXXXXXXXXXXoooOOOOX
XXXXXXXXXXXXXXXXXXXXXXXXXXXXXXooOOOOXX
XXXXXXXXXXXXXXXXXXXXXXXXXXXXXXXXXXXXXX
XXXXXXXXXXXXXXXXXXXXXXXXXXXXXXXXXXXXXX
