29,47,64,64,1800,1500
XXXXXXXXXXXXXXXXXXXXXXXXXXXXX
XXXXXXXXXXXXXXXXXXXXXXXXXXXXX
XXXXXXXXXXXXXXXXXXXXXXXXXXXXX
XXXXXXXXXXXXXXXXXXXXXXXXXXXXX
XXXXXXXXXXXXXXXXXXXXXXXXXXXXX
XXXXXXXXXXXXXXXXXXXXOOOOOOXXX
XXXOOOXXXXXXXXXXXXXXOOOOOOOXX
XXOOOOXXXXXXXXXXXXXOOOOOOOOXX
XXOOOOOXXXXXXXXXXXXOOOOOOOOOX
XOOOOOOXXXXXXXXXOOOOOOOOOOOOX
XOOOOOOOXOOOXXXOOOOOOoOOOOOOX
XOOOOOOOOOOOXXOOOOOOOoOOOOOOX
XOOOOOOOOOOOXXXOOOOOOooOOOOOX
XOOOOOOOOOOOXXOOOOOOooOOOXOXX
XXOOOOOOOOOOOXOOOOOOOXXOOXXXX
XXOOOOOXXXOOOOOOOOOOXXXOXXXXX
XXXXXXXXXXOOOOOOOOOOOXXXXXXXX
XXXXXXXXXXOOOOOOOOOOXXXXXXXXX
XXXXXXXXXXOOOOOOOOOOXXXXXXXXX
XXXXXXXXXXOOOOOOOOXXXXXXXXXXX
XXXXXXXXXXXOOOOOOXXXXXXXXXXXX
XXXXXXXXXXOOOOOOXXXXXXXXXXXXX
XXXXXXXXXOOOOOOOXXXXXXXXXXXXX
XXXXXXXOOOOOOOOXXXXXXXXXXXXXX
XXXXXXXOOOOOOOOOXXXXXXXXXXXXX
XXXXXXOOOOOOOOOOXXXXXXXXXXXXX
XXXXXXOOOOOOOOOOOOXXXXXXXXXXX
XXXXXXOOOOOOXOOOOOOOXXXXXXXXX
XXXXXXOOoOXXXXOOOOOOOXXXXXXXX
XXXXOOOoXXXXXOOOOOOOOXXXXXXXX
XXXXOOOoXXXXXOOOOOOOOOXXXXXXX
XXXOOOOXXXXXOOOOOOOOOOXXXXXXX
XXXOOOOOXXXXXOOOOOOOOOOXXXXXX
XXOOOOOOOOXOOOOOOOOOOOOXXXXXX
XXOOOOOOOOOOOOOOXOoOOOOOOXXXX
XOOOOOOOOOOOOOOXXooOOOOOOXXXX
XOOOOOOOOOOOOOOXXXXOOOOOOOOXX
XOOOOOOOOOOOOOXXXXXOOOOOOOOXX
XOOOOOOOOOOOOOXXXXXXXOOOOOOOX
XOOOOOOOOOOOOOXXXXXXXOOOOOOOX
XOOOOOOOOOOOOOXXXXXXXXOOOOOOX
XOOOOOOOOOOOOOXXXXXXXOOOOOOOX
XOOOOOOOOOOXOOXXXXXXXXOOOOOOX
XOOOOOOOOOXXOXXXXXXXXXOOOOOOX
XXOOOOOOOOXXXXXXXXXXXXXOOOOOX
XXXXXXXXXXXXXXXXXXXXXXXXXXXXX
XXXXXXXXXXXXXXXXXXXXXXXXXXXXX
