26,60,64,64,1663,1900
XXXXXXXXXXXXXXXXXXXXXXXXXX
XXXXXXXXXXXXXXXXXXXXXXXXXX
XXXXXXXXXXXXXXXXXXXXXXXXXX
XXXXXXXXXXXXXXXXXXXXXXXXXX
XXOXXXXXXXXXXXXXXXXXXXXXXX
XOOXXXXXXXXXXXXXXXXXXXXXXX
XOOOXXXXXXXXXXXXXXXXXXOOOX
XOOOXXXXXXXXXXXXXXXXXOOOOX
XOOOOOXXXXXXXXXXXXXXXOOOOX
XOOOOOXXXXXXXXXXXXXXOOOOOX
XOOOOOOXXXXXXXXXXXXXOOOOOX
XOOOOOOXXXXXXXXXXXXOOOOOOX
XXOOOOOOXXXXXXXXXXXOOOOOOX
XXOOOOOOXXXXXXXXXXOOOOOOXX
XXXOOOOOOXXXXXXXXXOOOOOOOX
XXXOOOOOOXOOXXXXXOOOOOOOOX
XXXXOOOOOOOOOXXXOOOOOOOOOX
XXXXOOOOOOOOOOXOOOOOOOOOOX
XXXXXOOOOOOOOOOOOOOOOOOOOX
XXXXXOOOOOOOOOOOOOOOOOOOXX
XXXXXXOOOOOOOOOOOOOOOOOOXX
XXXXXOOOOOOOOOOOOOOOOOOXXX
XXXXOOOOOoOOOOOOOOOOOOOXXX
XXXOOOOOooOOOOOOOOOOOXXXXX
XXXOOOOooooooOOOOOOOOXXXXX
XXOOOOoooooooOOOOOOOXXXXXX
XXOOOOOoooooooOOOOOOXXXXXX
XOOOOOoooooooOOOOOOXXXXXXX
XOOOOOooooooooOOOOOOXXXXXX
XOOOOOooooooooOOOOOOXXXXXX
XOOOOOOoooooooXOOOOOOXXXXX
XOOOOOOXXXXXXXXOOOOOOXXXXX
XOOOOOOXXXXXXXXXXOOOOOXXXX
XOOOOOXXXXXXXXXXXOOOOOOOXX
XOOOOOOXXXXXXXXXXOOOOOOOOX
XOOOOOOXXXXXXXXOOOOOOOOOOX
XOOOOOOXXXXXXXXOOOOOOOOOOX
XOOOOOOXXXXXXXOOOOOOOOOOOX
XOOOOOOOXXXXXXOOOOOOOOOOOX
XOOOOOOOXXXXXOOOOOOOOOoOOX
XOOOOOOOOXOOOOOOOOOOoOoooX
XOOOOOOOOOOOOOOOOOOooooooX
XXXXOOOOOOOOOOOOOOOOoooooX
XXXXOOOOOOOOOOOOOOOooooooX
XXXXOOOOOOOOOOOOOOOooooooX
XXXOOOOOOOOOOOOOOOooooooXX
XXXOOOOOOOOOOOOOOOOooXXXXX
XXOOOOOOOOOOOOOOOOOoXXXXXX
XXOOOOOOOOOOOOOOOOOOXXXXXX
XOOOOOOOOOOOOOOOOOOOXXXXXX
XOOOOOOOOOOOOOOOOOOOOOXXXX
XOOOOOOOOOOOOOOOOOOOOOXOXX
XOOOOOOOOOOOOOOOOOOOOOOOOX
XOOOOOOOoooOOOOOOOOOOOOOOX
XOOOOOOOoooooooOOOOOOOOOOX
XOOOOOOooooooooOOOOOOOOOOX
XOOOOOOoooooooooOOOOOOOOOX
XOOOOOOoooooooooOOOOOOOOXX
XXXXXXXXXXXXXXXXXXXXXXXXXX
XXXXXXXXXXXXXXXXXXXXXXXXXX
