58,77,64,64,3706,2454
XXXXXXXXXXXXXXXXXXXXXXXXXXXXXXXXXXXXXXXXXXXXXXXXXXXXXXXXXX
XXXXXXXXXXXXXXXXXXXXXXXXXXXXXXXXXXXXXXXXXXXXXXXXXXXXXXXXXX
XXXXXXXXXXXXXXXXXXXXXXXXXXXXXXXXXXXXXXXXXXXXXXXXXXXXXXXXXX
XXXXXXXXXXXXXXXXXXXXXXXXXXXXXXXXXXXXXXXXXXXXXXXXXXXXXXXXXX
XXXXXXXXXXXXXXXXXXXXXXXXXXXXXXXXXXXXXXXXXXOXXXXXXXXXXXXXXX
XXXXXXXXXXXXXXXXXXXXXXXXXXXXXXXXXXXXXXXOOOXXXXXXXXXXXXXXXX
XXXXXXXXXXXXXXXXXXXXXXXXXXXXXXXXXXXXXXXOOOXXXXXXXXXXXXXXXX
XXXXXXXXXXXXXXXXXXXXXXXXXXXXXXXXXXXXXXOOoXXXXXXXXXXXXXXXXX
XXXXXXXXXXXXXXXXXXXXXXXXXXoOXXXXXXXXXXOOooXXXXXXXXXXXXXXXX
XXXXXXXXXXXXXXXXXXXXXXXXXXoOXXXXXXXXOOOOooXXXXXXXXXXXXXXXX
XXXXOXXXXXXXXXXXXXXXXXXXXoooOXXXXXXXOOOOOoXXXXXXXXXXXXXXXX
XXXOOXXXXXXXXXXXXXXXXXXooOoOOXXXXXXXOOOOOoXXXXXXXXXXXXXXXX
XXOOOOXXXXXXXXXXXXXXXXXooOoOOXXXXXXXOOOOOOXXXXXXXXXXXXXXXX
XOOOOXXXXXXXXXXXXXXOXXOoOOOOXXXXOXXXOOOOOOXXXXXXXXXXXXXXXX
XOOOOXXXXXXXXXOXXXXOXXOooOoOXXXOOXXXOOOOOOOXXXXXXXXXXXXXXX
XOOOOXXOXXXXXOOOXOOOXOOoOOOXXOOOXXXOOOOOOOXXXXXXXXXXXXXXXX
XOOOOOXOOXXXXOOOOXOOOOOOOOOOOOOOOXXOOOOOOXXXXXXXXXXXXXXXXX
XOOOOOOOXXXXOOOOOOOOOOOOOOOOOOOOOOOOOOOOXXOXXXXXXXXXXXXXXX
XOOOOOOOXXXXOOOOOOOOOOOOOOOOOOOOOOOOOOOOXXOOXOOXXXXXXXXXXX
XOOOOOOOXXXXOOOOOOOOOOOXOOOOOOOOOOOOOOOOXXOOOOOXXXXXXXXXXX
XooOOOOOOOXXOOOOOOOOOOXXOOOOOOOOOOoooOOOOXXOOOOOXXXXXXXXXX
XooOOOOOOOOOOOOOOOOOOXXOOOOOOOOOoooooOOOOOXOOOOOOXXXXXXXXX
XoooOOOOOOOOOOOOOXOOOOOOOOOOOOOOoooooOOOOOOOOOOOOOXXXXXXXX
XoooOOOOOOOOOOOOXXXXOOOOOOOOooooooooooOOOOOOOOOOOXXXXXXXXX
XoooOOOOOOOOOOOOOOXXOOOOOOOOoooooooooooOOOOOOXXOOXXXXXXXXX
XooOOOOOOOOOOOOOOOOOOOOOOOOooooooooooooOOOOOXXXXXXXOXXXXXX
XoooOOOoOOOOOOOOOOOOOOOOOOOOooooooooooooOOOOOOXXOXXXOOOXXX
XoooOooooOOOOOOOOOOOOOOOOOOOoooooooooooOOOOOOOOOOOOOOoOXXX
XXoooOoooooOOOOOOOOOOOOOOOOOOXooooooooooOOOOOOOOOOOOOOoOXX
XXXXoooooooOOOOOOOOOOOOOOOXOXXXOOoOooooOOOOOOOOOOOOOOooOXX
XXXXXXooooooOOOOOOOOOOOOOOOOXXXOOOOooOOOOOOOOOOOOOOOXOoooX
XXXXXXooooooOOoOOOOOOOOOOOOOOOOOOOooXOOOOOOOOOOOOOOXXOoooX
XXXXXXXXooooooooOOOOOOOOOOOOOOOOOOOXXXOOOOOOOOOOOOOXXXOooX
XXXXXXXXXXXXooooooOOOOOOOOOOOOOOOOXXXXOOOOOOOOOOOXXXXXOXXX
XXXXXXXXXXXXXooooooOOOOXXOOOOOOOOOOOXXOOOOOOOOOOOOXXXXXXXX
XXXXXXXXXXXXoooooooOOOOXXXXXXXXOOOOOXOOOOXXOXOOOOOXXXXXXXX
XXXXXXXXXXXXXoooooooOOOXXXXXXXXXXXOOOOOOOXXXXXOOOOOOOXXXXX
XXXXXXXXXXXXXoooooooOOOXXXXXXXXXXXOOOOXXXXXXXXOOOOOOXXXXXX
XXXXXXXXXXXXXXooooooOOOXXXXXXXXXXXXOXXXXXXXXXXOOOOOOXXXXXX
XXXXXXXXXXXXXXoooooOOOOXXXXXXXXXXXXXXXXXXXXXXOOOOOOXXXXXXX
XXXXXXXXXXXXXXXooooOOOOXXXXXXXXXXXXXXXXXXXXXXXOOOOOXXXXXXX
XXXXXXXXXXXXXXXoOOOOOOOXXXXXXXXXXXXXXXXXXXXXXOOOOOXXXXXXXX
XXXXXXXXXXXXXXXOOOOOOOOXXXXXXXXXXXXXXXXXXXXXXOOOOXXXXXXXXX
XXXXXXXXXXXXXXXOOOOOOOOXXXXXXXXXXXXXXXXXXXXXOOOOOXXXXXXXXX
XXXXXXXXXXXXXXXXOOOOOOOXXXXXXXXXXXXXXXXXXXXXXOOOOOXXXXXXXX
XXXXXXXXXXXXXXXXOOOOOOOXXXXXXXXXXXXXXXXXXXXXOOOOOXXXOXXXXX
XXXXXXXXXXXXXXXXXXXOOOOXXXXXXXXXXXXXXXXXXXXXXOOOOOOOOXXXXX
XXXXXXXXXXXXXXXXXXOOOOOXXXXXXXXXXXXXXXXXXXXXOOOOOOOOOOOOXX
XXXXXXXXXOOXXXXXXXXOOOOXXXXXXXXXXXXXXXXXXXOOOOOOOOoOoOOOOX
XXXXXXXXOOXXXXXXXXOOOOXXXXXXXXXXXXXXXXXXOOOOOOOOOOOOOOoOOX
XXXXXXXXOOOOXXXXXXOOOOXXXXXXXXXXXXXXXXXXOOOOOOOOOOOOOOOOOX
XXXXXXXOOOOXXXXXOOOOOOXXXXXXXXXXXXXXXXXXOOOOOOOOOOOOOOoOOX
XXXXXXXOOOOXXXXOOOOOOOOXXXXXXXXXXXXXXXXXOOOOOOOOOOOOOOOOOX
XXXXXXXOOOXXXOOOOOOOOOXXXXXXXXXXXXXXXXXXOOOOOOOOOOOOOOoOOX
XOXXXXXOOOOXXOOOOOOOOOOXXXXXXXXXXXXXXXXXXOOOOOOOOOOOoOOoOX
XOXXXOOOOOOOOOOOOOOOOOOXXXXXXXXXXXXXXXXXXXOOOOOOOOOOOOoOOX
XOOOXXOOOOOOOOOOOOOOOOOOXXXXXXXXXXXXXXXXXXXOOOOOOOOOooooOX
XOOXXXOOOOOOOOoOOOOOOOOXXXXXXXXXXXXXXXXXXXXOOOOOOOOoooooXX
XOOOXXOOOOOOOOooOOoOOOOOXXXXXXXXXXXXXXXXXXXXOOOOOOOoooooXX
XOOOXOOOOOOOoooooooOOOOOOXXXXXXXXXXXXXXXXXXXXOOOOOOoooXXXX
XOOOOOOOOOOOooooooooOOOOOOXXXXXXXXXXXXXXXXXXXXOOOOOXXXXXXX
XOOOOOOOOOooooooooooOOOOOOOXXXXXXXXXXXXXXXXXXXOOOOXXXXXXXX
XOOOOOOOOOoooooooooooOOOOOOOOOOXXXXXXXXXXXXXXOOOOOXXXXXXXX
XOOOOOOOOOOoooooooooOOOOOOOOOOOOXXXXXXXXOOXOOOOOOXXXXXXXXX
XOOOOOOOOOOoooooooooOOOOOOOOOOOOXXXXXOOOOOOOOOOOOXXXXXXXXX
XXOOOOOOOOOoooooXooOOOOOOOOOOOOXXXXOOOOOOOOOOOOOXXXXXXXXXX
XXXOOOOOOOOOOXXoXXooOOOOOOOOOOOOXOOOOOOOOOOOOOOOOXXXXXXXXX
XXXXOOOOOOOOXXXXXooOOOOOOOOOOOOOOOOOOOOOOOOOOoOOXXXXXXXXXX
XXXXXXOOOOoOXXXXXXOOOOOOOOOOOOOOOOOOOOOOOOOOOooOOXXXXXXXXX
XXXXXXOOOooXXXXXXXOOOOOOOOOOOOOOOOOOOOOOOOOOOoOOOOXXXXXXXX
XXXXXXXXooXXXXXXXOOOOOOOOOXOOOOOOOOOOOOOOXXXXXooOOOXXXXXXX
XXXXXXXXoXXXXXXXOOOOOOOOOXXXXXXXXOOOXXXXXXXXXXooOOOXXXXXXX
XXXXXXXXXXXXXXXXOOOOOOOOXXXXXXXXXXXXXXXXXXXXXXXoooooooXXXX
XXXXXXXXXXXXXXXXOOOOOOOXXXXXXXXXXXXXXXXXXXXXXXXXoooooXXXXX
XXXXXXXXXXXXXXXXXXXOOOOXXXXXXXXXXXXXXXXXXXXXXXXXXoooXXXXXX
XXXXXXXXXXXXXXXXXXXXXXXXXXXXXXXXXXXXXXXXXXXXXXXXXXXXXXXXXX
XXXXXXXXXXXXXXXXXXXXXXXXXXXXXXXXXXXXXXXXXXXXXXXXXXXXXXXXXX
