47,63,64,64,3000,2000
XXXXXXXXXXXXXXXXXXXXXXXXXXXXXXXXXXXXXXXXXXXXXXX
XXXXXXXXXXXXXXXXXXXXXXXXXXXXXXXXXXXXXXXXXXXXXXX
XOOOOOOOOOOXXXXXXXXXXXXXXXXXXXOOOOXXXXXXXXXXXXX
XOOOOOOOOOOXXXXXXXXXXXXXXXXXXOOOOOOXXXXXXXXXXXX
XOOOOOOOOOOOOXXXXXXXXXXXXXXXXOOOOOOOXXXXXXXXXXX
XOOOOOOOOOOOOXXXXXXXXXXXXXXXOOOOOOOOXXXXXXXXXXX
XXXXXXXOOOOOOOOXXXXXXXXXXXXXXOOOOOOOOXXXXXXXXXX
XXXXXXXOOOOOOOOXXXXXXXXXXXXXXOOOOOOOOXXXXXXXXXX
XXXXXXXOOOOOOOOOXXXXXXXXXXXXXXOOOOOOOOXXXXXXXXX
XXXXXXOOOOOOOOOOXXXXXXXXXXXXXXOOOOOOOOOOOXXXXXX
XXXXXXXOOOOOOOOOOXXXXXXXXXXXXXOOOOoooOOOOOOXXXX
XXXXXXXOOOOOOOOOOXXXXXXXXXXXXOOOOooooOOOOOOXXXX
XXXXXXXXOOOOOOOOOOXXXXXXXXXXXOOOOoooooOOOOOOXXX
XXXXXXXOOOOOOOOOOOXXXXXXXXOOOOOOoooooOOOOOOOXXX
XXXXXXXXOOOOOOOOOOOXXXXXXXOOOOOOoooooOOOOOOOOXX
XXXXXXXXOOOOXXOOOOOXXXOXXOOOOOOoXXXooOOOOOOOXXX
XXXXXXXXXOOXXXXOOOOOOOOOXOOOOOOXXXXXooOOOOOOOXX
XXXXXXXXXXXXXXXOOOOOOOOOOOOOXOXXXXXXooOOOOOOOXX
XXXXXXXXXXXXXXXXOOOOOOOOOOOOXXXXXXXXXooOOOOOOXX
XXXXXXXXXXXXXXXOOOOOOOOOOOOXXXXXXXXXXoXOOXXOXXX
XXXXXXXXXXXXXXXOOOOOOOOOOOOOXXOXXXXXXXXXOXXXXXX
XXXXXOOXOXXXXXOOOOOOOOOOOOOOXOOXXXXXXXXXXXXXXXX
XXXOOOOOOOXXXXOOOOOOOOOOOOOOOOOOXXXXXXXXXXXXXXX
XXOOOOOOOOOOOOOOOOOOOOOOOOOOOOOXXXXXXXXXXXXXXXX
XXOOOOOOOOOOOOOOOOOOOOOOOOOOOOOOXXXXXXXXXXXXXXX
XOOOOOOOOOOOOOOOOOXOXOOOOOOOOOOXXXXXXXXXXXXXXXX
XOOOOOOOOOOOOOOOOOXXXXOOOOOOOOOOXXXXXXXXXXXXXXX
XOOOOOOOOOOOOOOOOXXXXXOOOOOOOOOXXXXXXXXXXXXXXXX
XOOOOOOOOOOOOXXXXXXXXXXOOOOOOOOOXXXXXXXXXXXXXXX
XOOOOOOOOOOXXXXXXXXXXXXOOOOOOOOXXXXXXXXXXXXXXXX
XXOOOOOOOOOXXXXXXXXXXXXXOOOOOOOOXXXXXXXXXXXXXXX
XXOOOOOOOOXXXXXXXXXXXXXXOOOOOOOXXXXXXXXXXXXXXXX
XXXXXXOOOXXXXXXXXXXXXXXXXOOOOOOOXXXXXXXXXXXXXXX
XXXXXXXXXXXXXXXXXXXXXXXXXOOOOOOXXXXXXXXXXXXXXXX
XXXXXXXXXXXXXXXXXXXXXXXXXXXOOOOOXXXXXXXXXXXXXXX
XXXXXXXXXXXXXXXXXXXXXXXXXXXXOOOOXXXXXXXXXXXXXXX
XXXXXXXXXXXXXXXXXXXXXXXXXXXXXOOOOXOOOOOXXXXXXXX
XXXXXXXXXXXXXXOOOXXXXXXXXXXXXOOOOOOOOOOXXXXXXXX
XXXXXXXXXXXXXOOOOOOXXXXOOOOXXOOOOOOOOOOOOOXXXXX
XXXXXXXXXXXXOOOOOOOXOOOOOOOOOOOOOOOOOOOOOOXXXXX
XXXXXXXXXXXXOOOOOOOOOOOOOOOOOOOOOOOOOOOOOOOXXXX
XXXXXXXXXXXOOOOOOOOOOOOOOOOOOOOOOOOOOOOOOOOXXXX
XXXXXXXXXOXOOOOOOOOOOOOOOOOOOOOOOOOOOOOOOOOOXXX
XXXXXXXOOOOOOOOOOOOOOOOOXXXOOOOOOOOOOOOOOOOOXXX
XXXXXXXOOOOOOOOOOOOOOOOOXXXXOOOOOOOOOOOOOOOOOXX
XXXXXXOOOOOOOOOOOOOOOOOXXXXXOOOOOOXXXXOOOOOOOXX
XXXXXXOOOOOOOOOOOOOOOOOXXXXXOOOOOOXXXXXOOOOOOOX
XXXXXOOOOOOOOOOOOOOOOOXXXXXOOOOOOXXXXXXOOOOOOOX
XXXXXOOOOOOOOOOOOOOOOOOXXXXOOOOOOXXXXXXXXXOOOOX
XXXXOOOOOOOOOOOOOOOOOOXXXXOOOOOOXXXXXXXXXXOOOOX
XXXXXOOOOOOOOOOOOOOOOOXXXXOOOOOOXXXXXXXXXXXOOOX
XXXXXOOOOOOOOOOOOOOOOOXXXOOOOOOOXXXXXXXXXXXOOOX
XXXXXXXOOOOOOOOOOOOOOOXXOOOOOOOOOXXXXXXXXXXXOOX
XXXXXXXXOOOOOOOOOOOOOOOOOOOOOOOOOOXXXXXXXXXXOOX
XXXXXXXXXOOOOOOOOOOOOOOOOOOOOOOOOOOXXXXXXXXXXOX
XXXXXXXXXOOOOOOOOOOOOOOOOOOOOOOOOOOXXXXXXXXXXXX
XXXXXXXXXXOOOOOOXXOOOOOOOOOOOOOOOOOXXXXXXXXXXXX
XXXXXXXXXXOOOOOXXXOOOOOOOOOOOOOOOOOXXXXXXXXXXXX
XXXXXXXXXXXOOOOXXXOOOOOOOOOOOOOOOOOXXXXXXXXXXXX
XXXXXXXXXXXXXXXXXOOOOOOOOOOOOOOOOOXXXXXXXXXXXXX
XXXXXXXXXXXXXXXXXOOOOOOOOOOOOOOOOOXXXXXXXXXXXXX
XXXXXXXXXXXXXXXXXXXXXXXXXXXXXXXXXXXXXXXXXXXXXXX
XXXXXXXXXXXXXXXXXXXXXXXXXXXXXXXXXXXXXXXXXXXXXXX
