33,53,64,64,2101,1687
XXXXXXXXXXXXXXXXXXXXXXXXXXXXXXXXX
XXXXXXXXXXXXXXXXXXXXXXXXXXXXXXXXX
XXXXXXXXXXXXXXXXXXXXXXXXXXXXXXXXX
XXXXXXXXXXXXXXXXXXXXXXXXXXXXXXXXX
XXXXXXXXXXXXXXXXXXXXXXXXXXXXXXXXX
XXOOOXXXXXXXXXXXXXXXXXXXXXXXXXXXX
XXOOOOOOXXXXXXXXXXXXXXXXXXXXXXXXX
XOOOOOOOXXXXXXXXXXXXXXXXXXXXXXXXX
XOOOOOOOOXXXXXXXXXXXXXXXXXXXXXXXX
XOOOOOOOOXXXXXXXXXXXXXXXXXXXXXXXX
XOOOOOOOOOXXXXXXXXXXXXXXXXXXXXXXX
XOOOOOOOOOXXXXXXXXXXXXXXXXXXXXXXX
XOOOOOOOOOOXXXXXXXXXXXXXXXXXXXXXX
XoOOOOXXOOOXXXXXXXXXXXXXXXXXXXXXX
XooOOOXXXOOOOOOOOOXXXXXXXXXXXXXXX
XooOOOXXXOOOOOOOOOXXXXXXXXXXXXXXX
XooOOOXXXXOOOOOOOOOXXXXXXXXXXXXXX
XooOOXXXXOOOOOOOOOOXXXXXXXXXXXXXX
XXXXXXXXXXOOOOOOOOOOXXXXXXXXXXXXX
XXXXXXXXXXOOOOOOOOOXXXXXXXXXXXXXX
XXXXXXXXXXXOOOOOOOOXXXXXXXXXXXXXX
XXXXXXXXXXOOOOooOOXXXXXXXXXXXXXXX
XXXXXXXXXXOOOOoooOXXXOOOOXXXXXXXX
XXXXXXXXXXOOOooXXXXXOOOOOXXXXXXXX
XXXXXXXXXXXOOooXXXXXOOOOOXXXXXXXX
XXXXXXXXXXXoOXXXXXXOOOOOOXXXXXXXX
XXXXXXXXXXXXoOXXXXXXOOOOOOXXXXXXX
XXXXXXXXXXXooOXXXXXXOOOOOOXXXXXXX
XXXXXXXXXXXooOOXXXXXOOOOOOXXXXXXX
XXXXXXXXXXooOOoooXXOOOOOOXXXXXXXX
XXXXXXXXXXOoOOooooXOOOOOOOXXXXXXX
XXXXXXXXOOOOOOooooOOOOOOOOXXXXXXX
XXXXXXOOOOOOOOooooOOOOOOOOOXXXXXX
XXXXXOOOOOOOOOoooOOOOOOOOOOXXXXXX
XXXXXOOOOOOOOOOoooOOOOOOOOOXXXXXX
XXXXOOOOOOOOOOoooOOOOOOOOOOXXXXXX
XXXXOOOOOOOOOOooooOOOOOOOOOOOXXXX
XXXOOOOOOOooOOooooOOOOoOOOOOOOXXX
XXXXOOOOOOoooOOooooOOOooOOOOOOOXX
XXXXOOOOOooooOooooOOOoooOOOOOOXXX
XXXXOOOOOOooooOoooOOOOXXOOoOOOOXX
XXXXOOOOOOoooOOoXXOOOXXOOooOOOXXX
XXXXXOOOOOOoooOOXXXOXXXOOoooOOOXX
XXXXOOOOOOOoooOOXXXXXXOOOooXOOOXX
XXXXXOOOOOOXoXOOOXXXXOOOOOXXXOOOX
XXXXXOOOOOXXXXOOOOOOOOOOOXXXXOOOX
XXXXXXOOOOOXXXOOOOOOOOOOOXXXXOOOX
XXXXXXOOOOOXOOOXOOOOOOOOOXXXOOOOX
XXXXXXXOOOOOOOOXXOOOXXOOOOOOOOOOX
XXXXXXXOOOOOOOXXXXXXXXOOOOOOOOOXX
XXXXXXXXOOOOOOXXXXXXXXXOOOOOOOOXX
XXXXXXXXXXXXXXXXXXXXXXXXXXXXXXXXX
XXXXXXXXXXXXXXXXXXXXXXXXXXXXXXXXX
