30,39,64,64,1880,1238
XXXXXXXXXXXXXXXXXXXXXXXXXXXXXX
XXXXXXXXXXXXXXXXXXXXXXXXXXXXXX
XXXXXXXXXXXXXXXXXXXXXXXXXXXXXX
XXXXXXXXXXXXXXXXXXXXXXXXXXXXXX
XXXXXoooooooXXXXXXXXXXXXXXXXXX
XXXXooooooooXXXXXXXXXXXXXXXXXX
XOOOoooooooooXXXXXXXXXXXXXXXXX
XOOOooooooooOXXXXXXXXXXXXXXXXX
XOOOooooooooOOXXXXXXXXXXXXXXXX
XOOOooooooooOOXXXXXXXXXXXXXXXX
XOOOooooooooOOOXXXXXXXXXXXXXXX
XOOooooXXXooOOOXXXXXXXXXXXXXXX
XOOOoooXXXXoOOOOXXXXXXXXXXXXXX
XOOOooXXXXXoOOOXXXXXXXXXXXXXXX
XOOOOoXXXXXXOOOOXXXXXXXXXXXXXX
XOOOOOXXXXXXOOOXXXXXXXXXXXXXXX
XOOOOOOXXXXXXOXXXXXXXXXXXXXXXX
XOOOOOOOOOXXXXXXXXXOXXXXXXXXXX
XOOOOOOOOOOOXXXXXXXOOXXXXXXXXX
XOOOOOOOOOOOXXXXXXOOOOXXXXXXXX
XOOOOOOOOOOOXXXXXXXOOOOOOOOOXX
XOOOOOOOXXXXXXXXXXXXOOOOOOOOOX
XOOOOOOOXXXXXXXXXXXXXXOOOOOOOX
XOOOOOOXXXXXXXXXXXXXXXOOOOOOOX
XOOOOOOXXXXXXXXXXXXXOOOOOOOOOX
XOOOOOOXXXXXXXXXXXXOOOOOOOOOOX
XoOOOOOOXXXXXXXXXXOOOOOOOOOOOX
XoOOOOOOOOOXXXXXOOOOOOOOOOOOXX
XooOOOOOOOOOXXXXOOOOOOOOOOOOXX
XoooOOOOOOOOXXXOOOOOOOOOOOOXXX
XooooOOOOOOOXXXOOOOOOOOOOOOXXX
XoooOOOOOOOOXXOOOOOOOOOOXXXXXX
XXooOOOOOOOOOOOOOOOOOOOXXXXXXX
XXoOOOOOOOOOOOOOOOOOOOXXXXXXXX
XXOOOOOOOOOOOOOOOOOOOOXXXXXXXX
XOOOOOOOOOOOOOOOOOOOOOXXXXXXXX
XXOOOOOOOOOOOOOOOOOOOOOXXXXXXX
XXXXXXXXXXXXXXXXXXXXXXXXXXXXXX
XXXXXXXXXXXXXXXXXXXXXXXXXXXXXX
