29,47,64,64,1800,1500
XXXXXXXXXXXXXXXXXXXXXXXXXXXXX
XXXXXXXXXXXXXXXXXXXXXXXXXXXXX
XXXXXXXXXXXXXXXXXXXXXXXXXXXXX
XXXXXXXXXXXXXXXXXXXXXXXXXXXXX
XXXXXXXXXXXXXXXXXOOXXXXXXXXXX
XXXXXXXXXXXXXXXXOOXXXXXXXXXXX
XXXXXXXXXXXXOOXXOOXXXXXXOoXXX
XXXXXXXXXXOOOOOOOOXXXXOOOoXXX
XXXXXXXXXXOOOOOOOOOOXXOOOoXXX
XXXXXXXXXoOOOOOOOOOOOOOOOXXXX
XXXXXXXXXOOOOOOOOOOOOOOOOXXXX
oOXXXXXXXOOOOOOOOOOOoOOOXXXXX
XoOXXXXXXOOOOOOOOOOOOOOOXXXXX
ooOXXXXXOOXXOOOOOOOOOOOOXXXXX
XooOXXXXOOXXXOXOOOOXXOXXXXXXX
ooOOXXXOOXXXXXXXXXXXXXXXXXXXX
XoOOOXXOOXXXXXXXXXXXXXXXXXXXX
XoOOOOOOOXXXXXXXXXXXXXXXXXXXX
XXoOoOOOOOXXXXXXXXXXXXXXXXXXX
XXooooOOOOOXXXXXXXXXXXXXXXXXX
XXXoooooOOOOXXXXXXXXXXXXXXXXX
XXXoooooOOOXXXXXXXXXXXXXXXXXX
XXXXooooOXOOXXXXXXXXXXXXXXXXX
XXXXXXooXXOOXXXXXXXXXXXXXXXXX
XXXXXXXoXXXOOXXXXXXXXXXOXXXXX
XXXXXXXXXXXOOOXXXXXXOXOXXXXXX
XXXXXXXXXXXXOOOXXXXOOOOOXXXXX
XXXXXXXXXXXXXOOXXXOOOOOOXOXXX
XXXXXXXXXXXXXXOOOOOOOOOOOOooX
XXXXXXXXXXXXXXOOOOOOOOOoOooXX
XXXXXXXXXXXXXXOOOOOOOOOoXXXXX
XXXXXXXXXXXXXXOOOOOOOXXXXXXXX
XXXXXXXXXXXXXXOOOOOOOOXXXXXXX
XXXXXXXXXXXXXXOOOOOOOXXXXXXXX
XXXXXXXXXXXXXXOOOOOOOXXXXXXXX
XXXXXXXXOXXXOOOOOOOXXXXXXXXXX
XXXXXXXXOOOOOOOOXOOOXXXXXXXXX
XXXXXXXXOOOOOOOXXXOOXXOXXXXXX
XXXXXXXXOOXOOOOXXXXOOXOOXXXXX
XXXXXXXOOXXXOXXXXXXOOOOOXXXXX
XXXXoOOOOXXXXXXXXXXXOOOOOOOOX
XXXooOoXXXXXXXXXXXXXOOOOOOOOX
XooooooXXXXXXXXXXXXXOOOOOOOOX
ooooooXXXXXXXXXXXXXOOOOOOOOOX
XoooooXXXXXXXXXXXXXXOOOOOOOOX
oooooXXXXXXXXXXXXXXOOOOOOOOXX
XXXXXXXXXXXXXXXXXXXXXXXXXXXXX
