29,47,64,64,1800,1500
XXXXXXXXXXXXXXXXXXXXXXXXXXXXX
XXXXXXXXXXXXXXXXXXXXXXXXXXXXX
XOOOOOOOOOOOOOOOOOXXXXXXXXXXX
XOOOOOOOOOOOOOOOOOXXXXXXXXXXX
XoooOOOOOOOOOOOOOOOXXXXXXXXXX
XoooOOOOOOOOOOOoOOOXXXXXXXXXX
XooooOOOOOOOOOOooOOOXXXXXXXXX
XooooOOOOOOOOOoooOOXXXXXXXXXX
XooooOOOOOOOoOXooOOOXXXXXXXXX
XooooOOOOooOoXXXOOOXXXXXXXXXX
XoooooOoOoooXXXXXOOOXXXXXXXXX
XooooooooXXXXXXXOOOXXXXXXXXXX
XXoXooXXXXXXXXXXOOOXXXXXXXXXX
XXXXXXXXXXXXXXOOOOXXXXXXXXXXX
XXXXXXXXXXXXXOOOOOXXXXXXXXXXX
XXXXXXXXXXXXOOOOOXXXXXXXXXXXX
XXXXXXXXXXXXOOOOOXXXXXXXXXXXX
XXXXXXXXXXOOOOOOXXXXXXXXXXXXX
XXXOOOOOXXOOOOOOXXXXXXXXXXXXX
XXOOOOOOXXOOOOOXXXXXXXXXXXXXX
XXXOOOOOOXOOOXXXXXXXXXXXXXXXX
XXXOOOOOOOOXXXXXXXXXXXXXXXXXX
XXXOOOOOOOOXXXXXXXXXXXXXXXOOX
XXOOOOOOOOOXXXXXXXXXXXXXOOOXX
XXOOOOOOOOOXXXXXXOXXXXOXOOOXX
XOOOOOXXXOOXXXXXOOXXXXOOOOXXX
XOOOOOXXXXOOOXXXOOOXXXOOOOXXX
XOOOXXXXXOOOOXOOOOOOXXOOOXXXX
XXOOXXXXXOOOOOOOOXOOOXOOOOXXX
XXXXXXOOOOOOOOOXXXOOOOOOOOXXX
XXXXXOOOOOOOOOOOOXXOOOOOOOOXX
XXXOOOOOOOOOOOOOOXXOOOXXXOXXX
XXXOOOOOOOOOOOOOOXXOOXXXXXXXX
XXXOOOOOOOOOOOOOOXOOXXXXXXXXX
XXXOOOOOOOOOOOOOOOXOXXXXXXXXX
XXOOOOOOOOOOOOOOOOXXXXXXXXXXX
XXOOOOOOOOOOOOOOOOXXXXXXXXXXX
XXOOOOOOOOOOOOOOOXXXXXXXXXXXX
XXXOOOOOOOOOOOOOOXXXXXXXXXXXX
XXXOOOOOOOOOOOOOXXXXXXXXXXXXX
XXXXOOoooOOOOOOOOXXXXXXXXXXXX
XXXXOoooOOOOOOOOOXXXXXXXXXXXX
XXXXXOoooOOOOOOOOOXXXXXXXXXXX
XXXXXXOoOOOOOOOOOOXXXXXXXXXXX
XXXXXXXOOOOOOOOOOOOXXXXXXXXXX
XXXXXXXXXXXXXXXXXXXXXXXXXXXXX
XXXXXXXXXXXXXXXXXXXXXXXXXXXXX
