29,43,64,64,1800,1350
XXXXXXXXXXXXXXXXXXXXXXXXXXXXX
XXXXXXXXXXXXXXXXXXXXXXXXXXXXX
XXXXXXXXXoOOOOXXXXXXXXoOOOooX
XXXXXXXXoOOOOOXXOXXXXXoOOOooX
XXXXXXXXXOOOOOOOOOXXXXXoOOooX
XXXXXXXXXOOOOOOOOOOOoooOOoooX
XXXXXXXXXOOOOOOOOOOOOOOOOOooX
XXXXXXXXOOOOOOOOOOOOOOOOOOOOX
XXXXXXOOOOOOOOOOOOOOOOOOOOOOX
XXXXXOOOOOOOOOOoOOOOOOOOOOOOX
XXXXXOOOOOOOOOooooOOOOOOOOOOX
XXXXOOOOOOOOOoooooOOOOOOOooOX
XXXXXOOOOOOOOooooooOOOXOOoooX
XXXXXOOOOOOOoooooooOOXXXOoooX
XXXXXoOOOOOOooooooooOoXXXoooX
XXXXXXXOOOOOXXXooooooXXXXoooX
XXXXXXXOOOOXXXXXoooooXXXXXXXX
XXXXXXXOOOXXXXXXooooXXXXXXXXX
XXXXXXXXOOXXXXXXXoooXXXXXXXXX
XXXXXXXoOXXXXXXXXooXXXXXXXXXX
XXXXXXXooOXXXXXXXoooXXXXXXXXX
XXXXXXXoOOXXXXXXXoooXXXXXXXXX
XXXXXXXXOOOXXXXXXXOOoXXXXXXXX
XXXXXXXXOOooXXXXXoOOXXXXXXXXX
XXXXXXXXOOOooXXXXXOOOXXXXXXXX
XXXXXXXoOOOooXXXXOOOOXXXXXooX
XXXXXXXooOOOOOXXXXOOOOXXOoooX
XXXXXXXoOOOOOOOOXOOOOOOOooooX
XXXXXXXXoOOOOOOOOOOOOOOOooooX
XXXXXOXOOOOOOOOOOOOOOOOOooooX
XXXXXOOOOOOOOOOOOOOOOOOOOOooX
XXXXoOOOOOOOOOOOOOOOOOOOOoooX
XXXXooOOOOOOOOOOOOOOOOOOOOooX
XXXXOoOOOOOOOOOOOOOoOOooooooX
XXXXXOoOOOOOOOOOOOoooOooooooX
XXXXOOoOOOOOOOOOOoooooooooooX
XOXXOOooOOOOooOOooooooooooooX
XOOOOOoooOOooooOooooooooooooX
XOOOOooooOooooooooooooooooooX
XOOooooXooooooooooooooooooooX
XooooooXXoooooooooooooooooooX
XXXXXXXXXXXXXXXXXXXXXXXXXXXXX
XXXXXXXXXXXXXXXXXXXXXXXXXXXXX
