38,63,64,64,2400,2000
XXXXXXXXXXXXXXXXXXXXXXXXXXXXXXXXXXXXXX
XXXXXXXXXXXXXXXXXXXXXXXXXXXXXXXXXXXXXX
XXXXXXXXXXXXXXXXXXXXXXXXXXXXXXXXXXXXXX
XXXXXXXXXXXXXXXXXXXXXXXXXXXXXXXXXXXXXX
XXXXXXXXXXXXXXXXXXXXXXXXXXXXXXXXXXXXXX
XXXXXXXXXXXXXXXXXXXXXXXXXXXXXXXXXXXXXX
XXXXXXXXXXXXXXXXXXXXXXXXXXXXXXXXXXXXXX
XXXXXXXXXXXXXXXXXXXXXXXXXXXXXXXXXXXXXX
XXXXXXXXXXXXXXXXXXXXXXXXXXXXXXXXXXXXXX
XXXXXXXXXXXXXXXXXXXXXXXXXXXXXXXXXXXXXX
XXXXXXXXXXXXXXXXXOXXOXXXXXXXXXXXXXXXXX
XXXXXXXXXXXXXXXXXOXOOXXXXXXXXXXXXXXXXX
XXXXXXXXXXXXOXXXOOOOOXXXXXXXXXXXXXXXXX
XXXXXXXXXXXOOXXXOOOOOXXXXXXXXXXXXXXXXX
XXXXXXOOOXXXOOXXOOOOOXXXXXXXXXXXXXXXXX
XXXXXOOOOOXXOOXXOOOOOXXXXXXXXXXXXXXXXX
XXXXXOOOOOOXXOXXOOOOOOXXXXXXXXXXXXXXXX
XXXXXOOOOOXXOOXOOOOOOXXXXXXXXXXXXXXXXX
XXXXXXOOOOOXXOOOOOOOOOXXXXXXXXXXXXXXXX
XXXXXXOXOOXXOOOOOOOOOOXXXXXXXXXXXXXXXX
XXXXXXXXXOOXXOOOOOOOOOXXXXXXXXXXXXXXXX
XXXXXXXXXOOXOOOOOOOoOXXXXXXXXXXXXXXXXX
XXXXXXOXXOOOOOOOOOOooOXXXXXXXXXXXXXXXX
XXXXXOOXXOOOOOOOOoooooXXXXOXXXXXXXXXXX
XXXXXOOOXOOOOOOOOooooooOOOOOXXXXXXXXXX
XXXXoOOOOOOOOOOOOooooooOOOOXXXXXXXXXXX
XXXXooOOOOOOOOOOOoooooooOOOXXXXXXXXXXX
XXXXooOOOOOOOOOOoooooooOOOOOOXXXXXXXXX
XXXXXoOOOOOOOoOOOooooooOOOOOOOXXXXXXXX
XXXXXOOOOOOOooOOOooXooOOOOOOOOOOXXXXXX
XXXXXXOOOOOOooOOOOoXXoOOOOOOOOOOOOOXXX
XXXXXXOOOOOoooOOOOoXooOOOOOOOOOOOOOOXX
XXXXXXXOOOOOoooOOoooooOOOOOOOOOOOOOOOX
XXXXXXXOOOOoooOOooooooOOOOOOOOOOOOOOOX
XXXXXXXOOOOOoooOooooooOOOOOOOOOOOOOOOX
XXXXXXXOOOOooooooooooOOOOOOOOOOOOOOOOX
XXXXXXXOOooOoooooooXoOOOOOOOOOOOOOOOOX
XXXXXXOOoooooooooXXXoOOOOOOOOOOOOOOXXX
XXXXXOOOOooooXoooXXXXoOOOOOOOOOOOOOXXX
XXXOOOOOooXoXXXXXXXXXoOOOOOOOOOOOOOXXX
XXXOOOOOooXXXXXXXXXXXXXOOOOOOOOOOOOXXX
XOOOOOoooXXXXXXXXXXXXXXOOOOOOOOOOOXXXX
XOOOOOoooXXXXXXXXXXXXXXOOOOOOOOOOOOXXX
XOOOOoooXXXXXXXXXXXXXXOOOOOOOOOOOOOXXX
XOOOOOooXXXXXXXXXXXXXXOOOOOOOOOXOOOOXX
XOOOOOoXXXXXXXXXXXXOOOOOOOOOOXXXOOOOXX
XXOOOOOOXXXXXXXXXXXOOOOOOOXOXXXXXOOOOX
XXOOOOOOXXXXXXXXXXOOOOXXOXXXXXXXXOOOOX
XXXOOOOOXXXXXXXXXXOOOOXXXXXXXXXXXXOOOX
XXXOOOOXXXXXXXXXXXOOOOXXXXXXXXXXXXOOOX
XXXXXXOOXXXXXXXXXXOOOOXXXXXXXXOOXXOOOX
XXXXXXOOOOXXXXXXXXOOOOXXXXXXXOOOOOOOOX
XXXXXXXOOOOXXXXXXXOOOXXXXXXXOOOOOOOOOX
XXXXXXXOOOOXXXXXXXOXXXXXXXOOOOOOOOOOOX
XXXXXXXXOOOOXXXXXXOXXXXXXXOOOOOOOOOOOX
XXXXXXXXXXOOOOXXOOXXXXXXOOOOOOOOOOOOXX
XXXXXXXXXXXOOOOOOOXXXXXOOOOOOOOOOOOOXX
XXXXXXXXXXXOOOOOXXXXXOOOOOOOOOOOOOOOXX
XXXXXXXXXXXXXOOXXXXXOOOOOOOOOOOOOOOOXX
XXXXXXXXXXXXXXXXXXXOOOOOOOOOOOOOOOOXXX
XXXXXXXXXXXXXXXXXXXXOOOOOOOOOOOOOOOXXX
XXXXXXXXXXXXXXXXXXXXXXXXXXXXXXXXXXXXXX
XXXXXXXXXXXXXXXXXXXXXXXXXXXXXXXXXXXXXX
