35,53,64,64,2228,1674
XXXXXXXXXXXXXXXXXXXXXXXXXXXXXXXXXXX
XXXXXXXXXXXXXXXXXXXXXXXXXXXXXXXXXXX
XXXXOOOOOXXXXXXXXXXXXXXXXXXXXXXXXXX
XXXOOOOOOXXXXXXXXXXXXXXXXXXXXXXXXXX
XXXXXOOOOOooXXXXOXXXXXXXXXXXXXXXXXX
XXXXXOOOOoooXXOOXXXOOXXXXXXXXXXXXXX
XXXXXXOOOoooOOOOOXOOOOOOXXOXXXXXXXX
XXXXXXOOoooOOOOOOOOoOOoOOOOOXXXXXXX
XXXXXXXOooXXOOOOOOOoooooOOOOOXXXXXX
XXXXXXXOoXXXOOOOOOOooooooOOOOOOXXXX
XXXXXXXXXXXXXOOOOOOXXXooooOOOOOOXXX
XXXXXXXXXXXOOOOOOOOXXoooooOOOoOOXXX
XXXXXXXXXXoOOOoOOOOXOoooooOOOooOOXX
XXXXXXXXXXoOooooOooOOooooooOoooOXXX
XXXXXXXXXXoOooooOoooOooooooOoooOXXX
XXXXXXXXOOOOoooOOoooOoooXXXoXooOXXX
XXXXXXooOOOoooooOOooooooXXXXXooOoXX
XXXXXoooOOoooooOOooooooXXXXXXoooXXX
XXXXXooooOOXXooooOooOooXXXXXXOOOoXX
XXXXXoooOOXXXooOoooOXXXXXXXXXOOoXXX
XXXXXXoOOOXXXXoOOooXXXXXXXXXXOOOXXX
XXXXXXoOOXXoooOOOoXXXXXXXXXXXOOOXXX
XXXXXXXOOXXoooOOOoXXXXXXXXXXXOOOXXX
XXXXXXXXXXooOOOOOoXXXXXXXXXXXOOXXXX
XXXXXXXXXXooOOOOooXXXXXXXXXXXOOOXXX
XXXXXXXXXooOOOOoooXXXXXXXXXXXOOXXXX
XXXXXXXXXoooOOOoooXXXXXXXXXXXOOXXXX
XXXXXXXXXoooOOooooXXXXXooXXXOOXXXXX
XXXXXXXXXXooOOooooXXXXXooXXXOOOXXXX
XXXXXXXXXXooOOoooXXXXXooOXXOOOOXXXX
XXXXXXXXXXXoOOOOOXXXXXXoOOOOOOOXXXX
XXXXXXXXXXXoOOOOXXXXXXooOOOOOOOXXXX
XXXXXXXXXXXXOOOooXXXXXXoOOOOOOOXXXX
XXXXXXXXXXXXOOOoXXXXXXoOOOOOOoXXXXX
XXXXXXXXXXXXOOOooXXXXXXOOOOOOoXXXXX
XXXXXXXXXXXXOOooXXXXXXOOOOOOOXXXXXX
XXXXXXXXXXXXXOooXXXXXXXXXOOOOoXXooX
XXXXXXXXXXXXOOOoXXXXXXXXXOOOOOOoOoX
XXXXXXXXXXXXXOOoXXXXXXXXXXOOOOOOOoX
XXXXXXXXXXXXOOOOOXXXXXXXXXOOOOOOOoX
XXXXXXXXXXXXXOOOOOXXXXXXXXXOOOOOOoX
XXXXXXXXXXOOOOOOOOXXXXXXXXOOOOOOooX
XXXXXXXXXXOOOOOOOOXXXXXXXXXOOXXOOoX
XOXXXXXOXXOOOOOOOOXXXXXXXXOOOXXXXXX
XOOOOOOOOOOOOOOOOOOXXXXXXXXOOOXXXXX
XOOOOOOOOOOOOOOOOOOOXXXXXXOOOOXXXXX
XOOoOOOOOOOOOOOOOOOOOOOOOOOOOOOXXXX
XOoooOOOOOOOOOOOOOOOOOOOOOOOOOXXXXX
XoooooOOOooOOOOOOOoOOOOoooOOoOXXXXX
XoooooooooooOOOOOooOOooooooOoXXXXXX
XooooooooooooOOOOOoOOooooooOOoXXXXX
XXXXXXXXXXXXXXXXXXXXXXXXXXXXXXXXXXX
XXXXXXXXXXXXXXXXXXXXXXXXXXXXXXXXXXX
