52,72,64,64,3317,2291
XXXXXXXXXXXXXXXXXXXXXXXXXXXXXXXXXXXXXXXXXXXXXXXXXXXX
XXXXXXXXXXXXXXXXXXXXXXXXXXXXXXXXXXXXXXXXXXXXXXXXXXXX
XXXXXXXXOOOXXXOXXXXXXXXXXXXXXXXXXXXXXXXXXXXXXXXXXXXX
XXXXXXXXOOOOOOOXXXXXXXXXXXXXXXXXXXXXXXXXXXXXXXXXXXXX
XXXXXXXXOOOOOOOOXXXXXXXXXXXXXXXXXXXXXXXXXXXXXXXXXXXX
XXXXXXXXOOOOOOOOXXXXXXXXXXXXXXXXXXXXXXXXXXXXXXXXXXXX
XXXXXXXXOOOOOOOOOXXXXXXXXXXXXXXXXXXXXXXXXXXXXXXXXXXX
XXXXXXXXOOOOoOOOOXXXXXXXXXXXXXXXXXXXXXXXXXXXXXXXXXXX
XXXXXXXXOOOooooOOOXXXXXXXXXXXXXXXXXXXXXXXXXXXXXXXXXX
XXXXXXXOOOoooooOOOOOOOOOOOOXXXXXXXXXXXXXXXXXXXXXXXXX
XXXXXXXXOOooooooOOOOOOOOOOOXXXXXXXXXXXXXXXXXXXXXXXXX
XXXXXXXOOoooXXooOOOOOOOOOOOXXXXXXXXXXXXXXXXXXXXXXXXX
XXOOOXOOOoooXXXooOOOOOOOOOOXXXXXXXXXXXXXXXXXXXXXXXXX
XOOOOOOOooXXXXXooOOOOOOOOOOXXXXXXXXXXXXXXXXXXXXXXXXX
XXOOOOOOooXXXXXXooOOOOOOOOOXXXXXXXXXXXXXXXXXXXXXXXXX
XoOOOOOooXXXXXXXooOOOOOOOOOXXXXXXXXXXXXXXXXXXXXXXXXX
XXoOOOoooXXXXXXXXooOOOOOOOOXXXXXXXXXXXXXXXXXXXXXXXXX
XoooooooXXXXXXXXXoOOOOOOOOOXXXXXXXXXXXXXXXXXXXXXXXXX
XoooooooXXXXXXXXXXXOOOOOOOOXXXXXXXXXXXXXXXXXXXXXXXXX
XooooXXXXXXXXXXXXXXOOOOOOOOXXXXXXXXXXXXXXXXXXXXXXXXX
XXXoXXXXXXXXXXXXXXXXOOOOOOOOXXXXXXXXXXXXXXXXXXXXXXXX
XXXXXXXXXXXXXXXXXXXXOOOOOOOOXXXXXXXXXXXXXXXXXXXXXXXX
XXXXXXXXXXXXXXXXXXXXXOOOOOOOOOXXXXXXXXXXXXXXXXXXXXXX
XXXXXXXXXXXXXXXXXXXXOOooOOOOOOOXXOOXOOXXXXXXXXXXXXXX
XXXXXXXXXXXXXXXXXXXXOOooooOOOOOOOOOOOOOXXXXXXXXXXXXX
XXXXXXXXXXXXXXXXXXXOOoooooOOOOOOOOOOOOXXXXXXXXXXXXXX
XXXXXXXXXXXXXXXXXXXOOooooooOOOOOOOOOOOOXXXXXXXXXXXXX
XXXXXXXXXXXXXXXXXXOooooooooOOOOOOOOOOOXXXXXXXXXXXXXX
XXXXXXXXXXXXXXXXXXOooooooooooOOOOOOOOOXXXXXXXXXXXXXX
XXXXXXXXXXXXXXXXXOOooXXXXXXooOOOOOOOOOXXXXXXXXXXXXXX
XXXXXXXXXXXXXXXXXOOOoXXXXXXXoooOOOOOOOXXXXXXXXXXXXXX
XXXXXXXXXXXXOXOOOOOOXXXXXXXXoooOOOOOOOXXXXXXXXXXXXXX
XXXXXXXXXXXXOOOOOOOOOXXXXXXXXXoooOOOOOOXXXXXXXXXXXXX
XXXXXXXXXXXOOOOOOOOOXXXXXXXXXXoooOOOOOOXXXXXXXXXXXXX
XXXXXXXXXXXOOOOOOOOOXXXXXXXXXXXoooOOOOOOOXXXXXXXXXXX
XXXXXXXXXXOOOOOOOOOXXXXXXXXXXXXoooOOOOOOOOXXXXXXXXXX
XXXXXXXXXXXOOOOOOOOOXXXXXXXXXXXXoooOOOOOOOOXXXXXXXXX
XXXXXXXXXXXOOOOOOOOXXXXXXXXXXXXXoooOOOOOOOOXXXXXXXXX
XXXXXXXXXXXOOOOOOOOOXXXXXXXXXXXXXoooOOXXXOOXXXXXXXXX
XXXXXXXXXXXOOOOOOOOXXXXXXXXXXXXXXXooOOXXXXXXXXXXXXXX
XXXXXXXXXXXOOOOOOOOOXXXXXXXXXXXXXXXoOOXXXXXXXXXXXXXX
XXXXXXXXXXOOOOOOOOOOXXXXXXXXXXXXXXOOOOXXXXXXXXXXXXXX
XXXXXXXXXXOOOOOOOOOOOXXXXXXXXXXXXXXOOOOXXXXXXXXXXXXX
XXXXXXXXXXOOOOOOOOOOXXXXXXXXXXXXXXOOOOOXXXXXXXXXXXXX
XXXXXXXXXXOOOOOOOOOOXXXXXXXXXXXXXXXOOOOOXXXXXXXXXXXX
XXXXXXXXXXOOOOOOOOOXXXXXXXXXXXXXXXXOOOOOXXXXXXXXXXXX
XXXXXXXXXXOOOOOOOOOXXXXXXXXXXXXXXXXOOOOOOOOOOOOOOOXX
XXXXXXXXXXOOOOOOOOXXXXXXXXXXXXXXXXOOOOOOOOOOOOOOOOXX
XXXXXXXXXXXOOOOOOOXXXXXXXXXXXXXXXXXOOOOOOOOOOOOOOOOX
XXXXXXXXXXOOOOOOOOXXXXXXXXXXXXXXXXXOOOOOOOOOOOOOOOXX
XXXXXXXXXXXOOOOOOOXXXXXXXXXXXXXXXXXXOOOOOOOOOOOOOOOX
XXXXXXXXXXOOOOOOOOXXXXXXXXXXXXXXXXXXXOOOOOOOOOOOOOXX
XXXXXXXXXXOOOOOOOOXXXXXXXXXXXXXXXXXXXXOOOOOOOOOOOOOX
XOXXXXXXOOOOOOOOOXXXXXXXXXXXXXXXXXXXXXOOOOOOOOOOOOXX
XXOOOOOOOOOOOXOOOXXXXXXXXXXXXXXXXXXXXXOOOOOOOOOOOOXX
XOOOOOOOOOOXXXOOXXXXXXXXXXXXXXXXXXXXXOOOOOOOOOOOOXXX
XXOOOOOOOOOXXXXOXXXXXXXXXXXXXXXXXXXXXXOOOOOOOOOOOXXX
XOOOOOOOOOXXXXXXXXXXXXXXXXXXXXXXXXXXXOOOOOOOOOOOXXXX
XXOOOOOOOOOXXXXXXXXXXXXXXXXXXXXXXXXXXXOOOOOOOOOOXXXX
XOOOOOOOOOXXXXXXXXXXXXXXXXXXXXXXXXXXXOOOOOOOOOOOXXXX
XXOOOOOOOOOXXXXXXXXXXXXXXXXXXXXXXXXXXOOOOOOOOOOOXXXX
XOOOOOOOOOOXXXXXXXXXXXXXXXXXXXXXXXXXOOOOOOOOOOOXXXXX
XXOOOOOOOOOXXXXXXXXXXXXXXXXXXXXXXXXXOOOOOOOOOOOXXXXX
XoOOOOOOOOXXXXXXXXXXXXXXXXXXXXXXXOOOOOOOOOOOOOXXXXXX
XooOOOOOOOOXXXXXXXXXXXXXXXXXXXXXXOOOOOOOOOOOOOOXXXXX
XooOOoooOOXXXXXXXXXXXXXXXXXXXXXXXOOOOOOOOOOOOOXXXXXX
XoooOooooOOXXXXXXXXXXXXXXXXXXXXXXXOOOOOOOOOOOOOXXXXX
XoooooooOOXXXXXXXXXXXXXXXXXXXXXXXXXXOOOOOOOOOOXXXXXX
XooooooooOOXXXXXXXXXXXXXXXXXXXXXXXXXXOOOOOOOXXXXXXXX
XXXXXXXXXXXXXXXXXXXXXXXXXXXXXXXXXXXXXOOOXXXXXXXXXXXX
XXXXXXXXXXXXXXXXXXXXXXXXXXXXXXXXXXXXXXXXXXXXXXXXXXXX
XXXXXXXXXXXXXXXXXXXXXXXXXXXXXXXXXXXXXXXXXXXXXXXXXXXX
